*INFINITE LIFE*
*INFINITE AMMO*
*EXPLOSIVE BULLETS*
*GIANTS HEADS*
*ALL WEAPONS*
*SUMMON MR. MEESEEKS*
*ARMOR UP*
*LIFE UP*